1111111111111111
100000C000000001
1001000000000E01
1010011111111110
1010000000000001
1P10000C00000001
1111111111111111