11111111111111
1P000000011001
1000000E000101
10C00000001C11
11111111111111