11111111111111
1CCCPCCCCCCCE1
1CCCCCCCCCCCC1
1CCCCCCCCCCC11
1CCCCCCCCCC1C1
11111111111111