111111111111
1P0000C000E1
101111011111
100100000001
111101111101
1C0001000001
101111101C01
111111111111


324

ds
f
fff
f
ff
ffffffffffffffds
cvgjf
jhjhhhhhh 
