11111111111111
1P0000000000C1
10111110111101
1C000001000001
11101110111011
100010000000E1
10111011111111
1C0001C0000001
10111111111001
11111111111111