11111111111111111111
1P0000010000000C0001
10111110111111011101
1C0001000010000000E1
11101011110101111111
100010C0001001000001
10111011111010111101
1C0000000000C00000E1
10111111111111110001
11111111111111111111