11111111111111
111P1C000E0001
11111100000001
10C00000000C01
11111111111111