111111111
1E0000001
101110001
10001C001
111111111