1111111100
10000000E0
1011111010
1C00010000
1010111111
10001P00C0
1011101110
1000000001
1111111111