11111111111
1P000000001
11101110101
10001000101
10111011101
10100000001
10101111111
100000000E1
11111111111