111111111
1P00000E1
1110X1101
1C0010001
101111101
1000000C1
111111111