1111111111111111
100000E000000001
111111111100P001
1000000000000001111
100000C0000100111111
111111111111111111111111