1111111111111111111111111
1P00000000100000000000001
1011111110101111111111101
1000000010100000000010001
1111101011111011111011101
1000101000001010111111111
1011101111101010111111101
1000000000100000000000001
1111111110111111111011101
10000000C0100000000100001
101000000000000E000000001
1111111111111111111111111











